########################################################################################################
#......................................................................................................#
#......................................................................................................#
#......................................................................................................#
#......................................................................................................#
#......................................................................................................#
#......................................................................................................#
#......................................................................................................#
#......................................................................................................#
#.......................>..............................................................................#
#......................................................................................................#
#......................................................................................................#
#......................................................................................................#
#......................................................................................................#
#......................................................................................................#
#......................................................................................................#
#......................................................................................................#
#......................................................................................................#
#......................................................................................................#
#......................................................................................................#
#......................................................................................................#
#......................................................................................................#
#......................................................................................................#
#......................................................................................................#
#......................................................................................................#
#......................................................................................................#
#......................................................................................................#
#......................................................................................................#
#......................................................................................................#
#......................................................................................................#
#......................................................................................................#
########################################################################################################
